##TEST MAP 01
##FORMATTING AND LOADING IN-GAME
##Map Details
SZ1616
ST0808
OB0810
##Nodes
ND0404
ND1204
ND0812
##Heightmap
MP
3333333333333333
3333333333333333
3333333333333333
3333333333333333
3333311113333333
3333100001333333
3311020200011333
3100002220000133
3100202222000133
3310000220200133
3331000020001333
3333100000013333
3333311000133333
3333333111333333
3333333333333333
3333333333333333