##TEST MAP 01
##FORMATTING AND LOADING IN-GAME
##Map Details
SZ1616
ST0808
OB0810
##Nodes
ND0404
ND1204
ND0812
##Heightmap
MP
0000000000000000
0111111111111110
0122222222222210
0123333333333210
0122222222222210
0111111111111110
0000000000000000
0000000000000000
0000000000000000
0000000000000000
0000000000000000
0000000000000000
0000000000000000
0000000000000000
0000000000000000
0000000000000000